111111
1E1111
101C11
1000P0
111111
